1111111111111111111111111111111111111111
1000000000000000000000000000000000000001
1000000000000000000000000000000000000001
1000000000000000000000000000000000000001
1000011111111111111111111111111111100001
1000010000000010000000000000000000100001
1000010000000010000000000000000000100001
1000010000000000000000000000000000100001
1000010000000000000000000000000000100001
1000111110000000000000001111111111100001
1000000000000000000000000000000000100001
1000000000000000000000000000000000100001
1000111110000000000000000000000000100001
1000010000000000000000000000000000100001
1000010000000000000000000000000000100001
1000010000000000000000000000000000100001
1000010000000000000000000000000000100001
1000010000000000000000000000000000100001
1000010000000000000000000000000000100001
1000010000000000001000000001000000100001
1000010000000000001000000001000000100001
1000010000000000001000000001000000100001
1000010000000000001000000001000000100001
1000010000000000001000000001000000100001
1000010000000000001000000001000000100001
1000010000000000001000000001000000100001
1000010000000000001000000001000000100001
1000010000000000001000000001000000100001
1000010000000000000000000000000000100001
1000010000000000000000000000000000100001
1000010000000000000000000000000000100001
1000010000000000000000000000000000100001
1000010000000000000000000000000000100001
1000011111111111111111111111111111100001
1000000000000000000000000000000000000001
1000000000000000000000000000000000000001
1000000000000000000000000000000000000001
1000000000000000000000000000000000000001
1000000000000000000000000000000000000001
1111111111111111111111111111111111111111